1111111111111
1310000000001
1210111111101
1010100000101
1010101110101
1010101410101
1010100010101
1010111110101
1010000000101
1011111111101
1000000000001
1111111111111