1111111
100B001
1000001
1023001
1111111