1111111111111111
10001000100000f1
1010s01000rcr0f1
1510rrrrrrrrr0f1
1111rrrrrrrrr111
1031wawwwwwbw4f1
10110000001000f1
10200fffff1ffff1
1111111111111111